AAA	LYS	K
AAC	ASN	N
AAG	LYS	K
AAT	ASN	N
ACA	THR	T
ACC	THR	T
ACG	THR	T
ACT	THR	T
AGA	ARG	R
AGC	SER	S
AGG	ARG	R
AGT	SER	S
ATA	ILE	I
ATC	ILE	I
ATG	MET	M
ATT	ILE	I
CAA	GLN	Q
CAC	HIS	H
CAG	GLN	Q
CAT	HIS	H
CCA	PRO	P
CCC	PRO	P
CCG	PRO	P
CCT	PRO	P
CGA	ARG	R
CGC	ARG	R
CGG	ARG	R
CGT	ARG	R
CTA	LEU	L
CTC	LEU	L
CTG	LEU	L
CTT	LEU	L
GAA	GLU	E
GAC	ASP	D
GAG	GLU	E
GAT	ASP	D
GCA	ALA	A
GCC	ALA	A
GCG	ALA	A
GCT	ALA	A
GGA	GLY	G
GGC	GLY	G
GGG	GLY	G
GGT	GLY	G
GTA	VAL	V
GTC	VAL	V
GTG	VAL	V
GTT	VAL	V
TAA	STO	X
TAC	TYR	Y
TAG	STO	X
TAT	TYR	Y
TCA	SER	S
TCC	SER	S
TCG	SER	S
TCT	SER	S
TGA	STO	X
TGC	CYS	C
TGG	TRP	W
TGT	CYS	C
TTA	LEU	L
TTC	PHE	F
TTG	LEU	L
TTT	PHE	F
